wall	Wand
wall	Mauer
or	oder
and	und
fences	Zäune
exterior	extern
wood	Holz
wire	Draht
fence	Zaun
rocky	steinig
soils	Erden
world	Welt
farmers	Bauer
often	häufig
stone	Stein
fields	Felder
easier	leichter
field	Feld
laws	Gesetze
neighbour	Nachbar
known	bekannt
station	Bahnhof
built	gebaut
famous	berühmt
