WEARABLE DEVICES	可穿戴設備
INKJET PRINTERS	噴墨打印機
WEARABLE TECH	可穿戴技術
WEARABLE	可穿戴
Liquid metal	液態金屬
Data Science	數據科學
data mining	數據挖掘
knowledge discovery	知識探索
Data Scientists	數據科學家
the Department of Health and Human Services	衛生和公眾服務部
cut-off values	臨界值
fully evaluated	充分評估
serum pepsinogen I/II ratio	血清胃蛋白酶原 I/II的比值
are useful for	是很有用的
biopsies	組織活檢
bone conditions	骨條件
bone conditions	骨類疾病
treadmill	單調乏味的工作
elusive goal 	難以實現的目標
a sense of completion	完滿的感覺
to do list	待辦事項列表
